    #####           
    #   #           
    #b  #           
  ###  b##          
  #  b b #          
### # ## #   ###### 
#   # ## #####  gg# 
# b  b          gg# 
##### ### #p##  gg# 
    #     ######### 
    #######         